####################
#######       #    #
#  # ## ## #    ## #
#      ##   ##   # #
#      ##   #    # #
#                # #
#   ######   ##### #
#         ## ##    #
#         ## ##  # #
#   ######   #######
#         ## ##  # #
#      ##  ##    # #
#      # #   #   # #
###########      # #
#         ## ##  # #
#  ### ###     ### #
#                  #
#  ##### #####    ##
#######       #### #
####################