####################
#                  #
#  ######  ######  #
#  #    #  #    #  #
#  #    #  #    #  #
#  ######  ######  #
#                  #
#  ######  ######  #
#  #    #  #    #  #
#  ##############  #
#  #    #  #    #  #
#  ######  ######  #
#                  #
#  ######  ######  #
#  #    #  #    #  #
#  #    #  #    #  #
#  ######  ######  #
#                  #
####################
