####################
#                  #
#  ######  ######  #
#  #    #  #    #  #
#  #    #  #    #  #
#  ##  ##  ##  ##  #
#                  #
#  ##############  #
#  #            #  #
#  ######  ######  #
#  ##          ##  #
#  ######  ######  #
#                  #
#  ##############  #
#  #   ##  ##   #  #
#  #     12     #  #
#  ######  ######  #
#                  #
####################
