####################
####          #    #
#    ##########  ###
#       ###     ####
#       ###      # #
#####            # #
#       ###      # #
#       ###     ####
#                # #
#   ##  12  ##     #
#   ##      ##     #
#   ##      ## #####
##   ##    ##   ####
#      ####      ###
#####            ###
#                ###
#     ### ###    ###
#                # #
#######******#######
####################