####################
#         2        #
#  ######  ######  #
#  #    #  #    #  #
#  ######  ######  #
#  #    #  #    #  #
#  ######  ######  #
#                  #
#  ######  ######  #
#  #    #  #    #  #
#  ######  ######  #
#  #    #  #    #  #
#  ######  ######  #
#                  #
#  ######  ######  #
#  #    #  #    #  #
#  #    #  #    #  #
#  ######  ######  #
#        1         #
####################