####################
#        1         #
#  ###########  ####
#  #    *    #  #  #
#  #  #####  #  #  #
#  #  #   #  *  #  #
#  #  #   #  *  #  #
#  #  #####  #  #  #
#  #    *    #  #  #
#  ###########  ####
# *    * 2         #
#  ####* ####  #####
#  #  #* #  #**#   #
#  ####  ####  #####
#  ####  ####  #####
#  #  #  #  #  #   #
#     #####    ##*##
#       **     ****#
#*             #####
#  #  #  #  #  #   #
#  ####  ####  #####
#** **    **   * **#
####################