####################
#                  #
#  ####  ####  #####
#  #  #  #  #  #   #
#  ####  ####  #####
#  #  #  #  #  #   #
#  ####  ####  #####
#                  #
#  ####  ####  #####
#  #  #  #  #  #   #
#  ####  ####  #####
#  ####  ####  #####
#  #  #  #  #  #   #
#  ####  ####  #####
#                  #
#  ####  ####  #####
#  #  #  #  #  #   #
#  ####  ####  #####
#                  #
####################