####################
#######       #    #
#  # ## ## #    ## #
#      ##   ##   # #
#      ##   #    # #
#                # #
#   ######   ##### #
#         ## ##  # #
#         ## ##  # #
#   ######   #######
#         ## ##  ###
#      ##  ##   ####
#      # #   #   ###
###########      ###
#         ## ##  ###
#  ### ###     #####
#                # #
#  ##### #####    ##
#######       #### #
####################