####################
#######       #    #
#    ##########  ###
#       ###     ####
#       ###      # #
#####   ###      # #
#       ###      # #
#       ###     ####
#                # #
#   ##      ##     #
#   ##      ##     #
#   ##      ## #####
##   ##    ##   ####
#      ####      ###
#####            ###
#                ###
#     ### ###    ###
#                # #
#######      #######
####################