####################
#        1         #
#  ####  ####  #####
#  #  #  #  #  #   #
#  ####  ####  #####
#  #  #  #  #  #   #
#  ####  ####  #####
# *    * 2         #
#  ####* ####  #####
#  #  #* #  #**#   #
#  ####  ####  #####
#  ####  ####  #####
#  #  #  #  #  #   #
#     #####    ##*##
#       **     ****#
#*             #####
#  #  #  #  #  #   #
#  ####  ####  #####
#** **    **   * **#
####################